9ac00000
553c0000
51000000
5100f000
73000000